1111111111111111111111111111111
1000000000000000000000000000001
10C0000000000000000000000000001
1000000000000000000000000000001
1000000000000000000000000000001
1000000000000000000000000000001
1000000000000000000000000000001
10000000CCCCCCCCCCCCCCCCCC00001
10000000CCCCCCCCCCCCCCCCCC00001
10000000CCCCCCCCCCCCCCCCCC00001
10000000CCCCCCCCCCCCCCCCCC00001
10000000CCCCCCCCCCCCCCCCCC00001
10000000CCCCCCCCCCCCCCCCCC00001
10000000CCCCCCCCCCCCCCCCCC00001
1000000000000000000000000000001
1000000000000000000000000000001
1000000000000000000000000000001
1000000000000C00000000000000001
1000000000000000000000000000001
1000000000000000000000000000001
1000000000000000000000000000001
1000000000000000000000000000001
1000000000000000000000000000001
1000000000000000000000000000001
1000000000111111111011100000001
1000000000000000000000000000001
1000000000000000000000000000001
1000000000000000000000000000001
1000000000000000000000000000001
10000000000000000000000000E0001
1000000000000000000000000000001
10000000000000000000000000000P1
1111111111111111111111111111111