11111111111
1P000M00001
100M0000001
10000C00001
100011000E1
11111111111