11111111111111111
100000010000000C1
10110001001101001
10000000000000001
1000000C000000001
10100101000010001
10101000100101101
10001010C00000001
1000000C000010001
100C0000000001001
10000001000001001
10110001001101001
10100101000011001
10101000100101101
1000101000C000001
100000011100CE001
1000000C000000C01
100000000000000P1
11111111111111111