1111
1001
1111
1P01
1C01
1C01
1C01
1C01
1CE1
1111