1111111111111111111111111111111
1P0010C000000000000010000000001
10E01111000000100000C000001C001
1110C000000000C0000010000001001
1000CC000001001000000000C000001
1000CC01000000000000100C00C0001
10000000001000C0000000010000001
10010000000000001100000000C0001
1000000000000000000000000000001
100CC0100000010000000001000C001
100CC0000000000000110000000C001
1000000000000000000000000000001
1000000000000000CCC000000000001
1000000110000000CCC000000000001
1000000000000000CCC000000000001
10011100010000000000000C1001001
100000000000C10000001111C000001
1111100010000000000000010000101
1000C00000000000000000010C00001
1000111000C00000000000000000001
10001C0000000000CCCC00000000001
101C10000000000CCCCCC0000010001
1C0110010000000CCCCCC0000C00001
11C0000C00000000CCCC00000000001
1001000100001000000001000000001
1011000000000000100001000C00001
1C010C0000010000010001000000001
1101100000000000000001000000001
10001000010000001111110C0000001
10C0100000100000C00000000000001
10000C0000000000000000000000001
1111111111111111111111111111111