111111
1P0CM1
10EM01
1000C1
111111